- - - - - - - - -
- - - - - - - - -
- - - C C - C - -
- - - - - - - - -
- - - - - C - - -
- - - - - - C - -
- P - - - - - - -
- - - - - - - - -
- - - - - - - - -