- - - - - - - - -
- - - C - - - - -
- - - - C - - - -
- - - - - C - - -
- - - - - - C - -
- - - - - - - - -
- P - - - - - - -
- - - - - - - C -
- - - - - - - - -